8 10
##########
#x   c # #
# p     x#
#   #   ##
# c#  # x#
# g#  cxc#
#        #
##########
2 2