8 10
##########
#x   c # #
# p     x#
#   #   ###
# c#  # x#
#  #  cxc#
#        #
##########
