8 10
##########
#x   c # #
# p     x#
#   #   ##
# c#  # x#
#  #  cxc#
#  x c   #
##########
2 2